map:

4,4,4,4,4,4,4,4,4,4,4,4,4,4,4,4,4
4,1,1,1,1,1,1,1,1,1,1,1,1,1,1,1,4,
4,1,1,1,4,4,4,4,1,1,1,1,1,1,1,1,4,
4,1,1,1,4,1,1,1,1,1,1,1,1,1,1,1,4,
4,1,1,1,4,1,1,1,1,1,1,1,5,1,1,1,4,
4,1,1,1,4,1,1,1,1,1,1,1,1,1,1,1,4,
4,1,1,1,4,1,1,1,1,1,1,1,1,1,1,1,4,
4,1,1,1,1,1,1,1,1,1,1,1,1,1,1,1,4,
4,1,1,1,1,1,1,1,1,1,1,1,1,1,1,1,4,
4,4,4,4,4,4,4,4,4,4,4,4,4,4,4,4,4,

endmap:

id:1
texture: ./assets/floor_seamless.jpg
iswall: false

id:4
texture: ./assets/wall.jpg
iswall: true

id:5
texture: ./assets/wall.jpg
iswall: true

player:
positionx: 600
positiony: 600
texture: ./assets/stickman.png
hp: 3




